NO textures/1.xpm
SO textures/2.xpm
WE textures/4.xpm
EA textures/3.xpm

F 220,100,0
C 225,30,0

111111
100001
101001
10N0 1
111111
