NO textures/1.xpm
SO textures/2.xpm
WE textures/4.xpm
EA textures/3.xpm

F 220,100,0
C 225,30,0

1111111
10 0001
1010001
10000N1
1111111
